#########################
#########################
###@@@@@@@@##@@@@@@@@@###
####@###############@####
####@###############@####
####@###############@####
####@###############@####
####@###############@####
####@###############@####
####@###############@####
####@###############@####
####@###############@####
####@###############@####
####@###############@####
####@@@###########@@@####
######@###@@@@@###@######
######@###########@######
######@###########@######
#########################
#########################
#########################
@@@@@@@@@@#####@@@@@@@@@@
#########################
#########################
#########################